11111111111
10000011101
10111011101
10111000001
10111011101
10111011101
11111011111
11100000111
11101110111
10001110001
11111111111