1111111111111111111111111111111
1000000000000000000000000000001
1011111011101110111111111011101
1011111011101110111111111011101
1011111111111111111111111111111
1000001110111011100000001110111
1011101110111011101111101110111
1011100000000000001111100000001
1011111110111111111111111110111
1000111110111111111000111110111
1011111110111111111110111111111
1011101110000000001110111011101
1011101111111011101110111011101
1000000011111011100000000000001
1011111011111111101110111011101
1011111000001110001110111011101
1011111011101111101110111011111
1000111011101111101110111011111
1110111111101111111110111011111
1110001110000011111000111000001
1110111110111011111110111011101
1000111000111000001110111011101
1110111110111110111110111111111
1110001110001110111110001110111
1110111111101111111111101110111
1110111011100011100011100000111
1110111011111111101111101110111
1000000000111110001110001110001
1110111110111110111110111110111
1110111110000000111000111000111
1111111111111111111111111111111