1111111111111111111111111111111
1011101110000011100011100011101
1011101111101111111011111011101
1000000011101110111011111000001
1011111011101110111011111011101
1011111000000000000000000011101
1011111011101110111011111011111
1000111011101110111011111000111
1011111011101111111111111011111
1011111011100011101110000011101
1111111011111111101110111011101
1110000000111111101110111011101
1111101110111111101111111011101
1011101110000000000011111000001
1011111110111110111011111111111
1011111000111110111011101111111
1011111011111111111111101111111
1000000011111111101110000000001
1111111011111111101110111011101
1111111000111111101110111011101
1111111011111111101110111111101
1000000011101110000000001110001
1110111011101111101110111111101
1110111000000011101110111011101
1111111011101111101111111011101
1011100011101110000011111011101
1011111011101110111011111011111
1000111011100000111000000000111
1110111011111011111011101110111
1110000000111011100011101110001
1111111111111111111111111111101