1111111111111111111111111111111
1000000000000000000000111011101
1011101111101110111011111011101
1011101111101110111011111011101
1011101111111111111111111011101
1011100000111011101110000011101
1111101110111011101111111011101
1110001110000000000011111011101
1111101111101110111011111011101
1111100011101110111000000000001
1111101111101111111011101111101
1110001110000011100011101111101
1110111111101111111011111111111
1000111011101110111000111000111
1011111011101110111110111011111
1011111000000000001110000011101
1011111110111110111110111011101
1011101110111110111000111000001
1111101110111110111110111111101
1110001110111000001110001111101
1111101110111110111110111111101
1011100000001110111000111000001
1011111011101110111110111110111
1000111011101110001110001110111
1011111011111110111111101111111
1011100011111000111111100011111
1011111011111110111111111111111
1000111000001110111110111110111
1110111011111110111110111110111
1110000011111000000000000000000
1111111111111111111111111111111